#############
#...........#    ########
#...s...s...######..z...#
#.......................#
#...........######......#
#.....s.....#    #..z...#
#...........#    #......#
#...........#    #......#
#####..######    ###..###
    #..#           #..#
    #..#           #..#
    #..#          ##..##
  ###..####      #.....H#
  #..@....#      #.....C#
  #.......#      #.....S#
  #.......#      #.....A#
  #.......#      #w....D#
  #.......#      #.....X#
  #.......#      #......#
