31 23 1
29 1 1 1 1
              #$#
              #.#
  #############.#############
  #...@.....................#
  #.....................w...#
  #.........................#
  #.........................#
  #.........................#
  #.........................#
  #.........................#
  #.........................#
###.....................z...###
$.............................$
###.........................###
  #.........................#
  #.........................#
  #.........................#
  #.....................s...#
  #.........................#
  #.........................#
  #############.#############
              #.#
              #$#