15 20 1
7 0 15 21 0
#######$#######
#.............#
#.............#
#.............#
#.............#
#.............#
#.............#
#.............#
#.............#
#.............#
#.............#
#.............#
#.............#
#.............#
#.............#
#.............#
#.............#
#.............#
#.............#
#######$#######