27 14 0
###########################
#..###...###..#...#.#####.#
#.#.....#...#.##.##.#.....#
#.#..##.#####.#.#.#.#####.#
#.#...#.#...#.#...#.#.....#
#..###..#...#.#...#.#####.#
#............@............#
#..###..#...#.#####.####..#
#.#...#.#...#.#.....#...#.#
#.#...#.#...#.#####.####..#
#.#...#..#.#..#.....#.#...#
#..###....#...#####.#..#..#
#.........................#
###########################
