15 20 2
7 0 15 21 0
7 19 12 1 3
#######$#######
#w.t.......t.w#
#.tpt.....tpt.#
#..t.......t..#
#.............#
#..C..........#
#..t.......t..#
#.tpt.....tpt.#
#..t.......t..#
#..........H..#
#w...........w#
#..t.......t..#
#.tpt.....tpt.#
#..t.......t..#
#.............#
#w...........w#
#..t.......t..#
#.tpt.....tpt.#
#X.t.......t..#
#######$#######