15 20 2
7 0 15 21 0
7 19 12 1 3
#######$#######
#..t.......t..#
#.tpt.....tpt.#
#..t.......t..#
#.............#
#.............#
#..t.......t..#
#.tpt.....tpt.#
#..t.......t..#
#.............#
#.............#
#..t.......t..#
#.tpt.....tpt.#
#..t.......t..#
#.............#
#.............#
#..t.......t..#
#.tpt.....tpt.#
#..t.......t..#
#######$#######