25 12 1
12 0 7 18 2
############$############
#t.....................t#
#.......................#
#....###############....#
#....#t...........t#....#
#....#.....012.....#....#
#....#.....3o5.....#....#
#....#.....678.....#....#
#....#t...........t#....#
#.......................#
#t.....................t#
#########################