20 21 2
19 1 1 11 0
0 10 18 5 5
####################
#..................$
#z######.######.####
###w.....######....#
###t######......##.#
####.....#.####.####
#####.####.####....#
#####.##...#######.#
#tz...############.#
#######....#z......#
$...H#..##.#.#.##.##
#.####.###...####..#
#.###s..##########.#
#.###.#......#..#..#
#.#...######...##.##
#.#.#########.###..#
#.#....#......####.#
#.##z########...:#.#
#.################.#
#..................#
####################