20 21 1
19 1 1 11 0
####################
#..................$
#.######.######.####
###......######....#
###t######......##.#
####.....#.####.####
#####.####.####....#
#####.##...#######.#
#t....############.#
#######....#.......#
$....#..##.#.#.##.##
#.####.###...####..#
#.###...##########.#
#.###.#......#..#..#
#.#...######...##.##
#.#.#########.###..#
#.#....#......####.#
#.##.########....#.#
#.################.#
#..................#
####################