20 11 1
19 5 1 10 4
####################
#th...............t#
#...s...#..#......s#
#......s#.h#..s....#
#fffffff####fffffff#
#t.SSSD..L.........$
#fffffff####fffffff#
#vvvvvvv#vv#......h#
#..vvv..#vv#.......#
#t..vvvvvv...h....t#
####################