20 11 1
19 5 1 10 4
####################
#.h......cc.......s#
#...s...#..#.......#
#......s#.h#..s....#
#fffffff####fffffff#
#t.................$
#fffffff####fffffff#
#vvvvvvv#vv#......h#
#..vvv..#vv#.......#
#...vvvvvcc..h.....#
####################